############
#        O #
#      P ###
#          #
#######    #
# O  ##    #
#    ##    #
#          #
#       XX #
#       #  #
############
